R 800 600
NO   ./textures/wall_korean_n.xpm 
SO    ./textures/wall_korean_s.xpm
WE    ./textures/wall_korean_w.xpm
EA   ./textures/wall_korean_e.xpm
S   ./textures/skulls.xpm
F 224,   172,   105
C 205,   249,   255

11111
1W021
11111