R 123 456
NO   ./textures/brick.xpm 
SO    ./textures/blue.xpm
WE    ./textures/wood.xpm
EA   ./textures/grey.xpm
S   ./textures/chest.xpm
F 224,   172,   105
C 205,   249,   255

  1111
11N00111   1
11   111
11