R 1600 800
NO   ./textures/wall_korean_n.xpm 
SO    ./textures/wall_korean_s.xpm
WE    ./textures/wall_korean_w.xpm
EA   ./textures/wall_korean_e.xpm
S   ./textures/skulls.xpm
F 184,113,39
C 51,198,227

1111111111111111111111111
1000000000110000000000001
1011000001110000002000001
1001000000000000000000001
1111111110110000011100001
1000000000110000011111111
1111011111111101110000001
1111011111111101010101001
1100000011010101110000001
100020000S000000000000001
1000000000000000110101001
1100000111010101111101111
11110111 1110101 10111101
11111111 1111111 11111111